#######################################
# Syntax Coloring Map For BLE
#######################################

#######################################
# Datatypes (KEYWORD1)
#######################################

BLEDescriptor	KEYWORD1
BLECharacteristic	KEYWORD1
BLEService	KEYWORD1
BLEDevice	KEYWORD1

BLE	KEYWORD1

BLEUart	KEYWORD1

#######################################
# Methods and Functions (KEYWORD2)
#######################################

uuid	KEYWORD2
properties	KEYWORD2
permissions	KEYWORD2
fixedLength	KEYWORD2
valueSize	KEYWORD2
valueLength	KEYWORD2
value	KEYWORD2
setValue	KEYWORD2
writeValue	KEYWORD2
busy	KEYWORD2
written	KEYWORD2
subscribed	KEYWORD2
onRead	KEYWORD2
onWritten	KEYWORD2
onSubscribed	KEYWORD2
descriptorCount	KEYWORD2
descriptor	KEYWORD2
addDescriptor	KEYWORD2
removeDescriptor	KEYWORD2
characteristicCount	KEYWORD2
characteristic	KEYWORD2
addCharacteristic	KEYWORD2
removeCharacteristic	KEYWORD2
serviceCount	KEYWORD2
service	KEYWORD2
addService	KEYWORD2
removeService	KEYWORD2
address	KEYWORD2
connected	KEYWORD2
rssi	KEYWORD2
mtu	KEYWORD2
setConnectionInterval	KEYWORD2
getConnectionParameters	KEYWORD2
onConnectionUpdate	KEYWORD2
begin	KEYWORD2
end	KEYWORD2
setTxPowerLevel	KEYWORD2
setPreferredPhy	KEYWORD2
setDeviceName	KEYWORD2
setAppearance	KEYWORD2
setSecurity	KEYWORD2
setBonding	KEYWORD2
setPin	KEYWORD2
clearBondStorage	KEYWORD2
setIncludeTxPowerLevel	KEYWORD2
setIncludeConnectionInterval	KEYWORD2
setLocalName	KEYWORD2
setAdvertisedServiceUuid	KEYWORD2
setAdvertisedServiceUuids	KEYWORD2
setManufacturerData	KEYWORD2
setBeacon	KEYWORD2
setAdvertisingData	KEYWORD2
setScanResponseData	KEYWORD2
setAdvertisingInterval	KEYWORD2
setConnectable	KEYWORD2
setDiscoverable	KEYWORD2
advertise	KEYWORD2
stopAdvertise	KEYWORD2
advertising	KEYWORD2
central	KEYWORD2
disconnect	KEYWORD2
onStop	KEYWORD2
onConnect	KEYWORD2
onDisconnect	KEYWORD2

#######################################
# Constants (LITERAL1)
#######################################


BLE_OPTION_RANDOM_STATIC_ADDRESS	LITERAL1
BLE_OPTION_PRIVACY	LITERAL1
BLE_OPTION_NO_SERVICE_CHANGED	LITERAL1
BLE_OPTION_READ_ONLY_DEVICE_NAME	LITERAL1
BLE_OPTION_PERIPHERAL	LITERAL1
BLE_OPTION_CENTRAL	LITERAL1
BLE_OPTION_PERIPHERAL_AND_CENTRAL	LITERAL1
BLE_APPEARANCE_UNKNOWN	LITERAL1
BLE_APPEARANCE_GENERIC_PHONE	LITERAL1
BLE_APPEARANCE_GENERIC_COMPUTER	LITERAL1
BLE_APPEARANCE_GENERIC_WATCH	LITERAL1
BLE_APPEARANCE_WATCH_SPORTS_WATCH	LITERAL1
BLE_APPEARANCE_GENERIC_CLOCK	LITERAL1
BLE_APPEARANCE_GENERIC_DISPLAY	LITERAL1
BLE_APPEARANCE_GENERIC_REMOTE_CONTROL	LITERAL1
BLE_APPEARANCE_GENERIC_EYE_GLASSES	LITERAL1
BLE_APPEARANCE_GENERIC_TAG	LITERAL1
BLE_APPEARANCE_GENERIC_KEYRING	LITERAL1
BLE_APPEARANCE_GENERIC_MEDIA_PLAYER	LITERAL1
BLE_APPEARANCE_GENERIC_BARCODE_SCANNER	LITERAL1
BLE_APPEARANCE_GENERIC_THERMOMETER	LITERAL1
BLE_APPEARANCE_THERMOMETER_EAR	LITERAL1
BLE_APPEARANCE_GENERIC_HEART_RATE_SENSOR	LITERAL1
BLE_APPEARANCE_HEART_RATE_SENSOR_HEART_RATE_BELT	LITERAL1
BLE_APPEARANCE_GENERIC_BLOOD_PRESSURE	LITERAL1
BLE_APPEARANCE_BLOOD_PRESSURE_ARM	LITERAL1
BLE_APPEARANCE_BLOOD_PRESSURE_WRIST	LITERAL1
BLE_APPEARANCE_GENERIC_HID	LITERAL1
BLE_APPEARANCE_HID_KEYBOARD	LITERAL1
BLE_APPEARANCE_HID_MOUSE	LITERAL1
BLE_APPEARANCE_HID_JOYSTICK	LITERAL1
BLE_APPEARANCE_HID_GAMEPAD	LITERAL1
BLE_APPEARANCE_HID_DIGITIZERSUBTYPE	LITERAL1
BLE_APPEARANCE_HID_CARD_READER	LITERAL1
BLE_APPEARANCE_HID_DIGITAL_PEN	LITERAL1
BLE_APPEARANCE_HID_BARCODE	LITERAL1
BLE_APPEARANCE_GENERIC_GLUCOSE_METER	LITERAL1
BLE_APPEARANCE_GENERIC_RUNNING_WALKING_SENSOR	LITERAL1
BLE_APPEARANCE_RUNNING_WALKING_SENSOR_IN_SHOE	LITERAL1
BLE_APPEARANCE_RUNNING_WALKING_SENSOR_ON_SHOE	LITERAL1
BLE_APPEARANCE_RUNNING_WALKING_SENSOR_ON_HIP	LITERAL1
BLE_APPEARANCE_GENERIC_CYCLING	LITERAL1
BLE_APPEARANCE_CYCLING_CYCLING_COMPUTER	LITERAL1
BLE_APPEARANCE_CYCLING_SPEED_SENSOR	LITERAL1
BLE_APPEARANCE_CYCLING_CADENCE_SENSOR	LITERAL1
BLE_APPEARANCE_CYCLING_POWER_SENSOR	LITERAL1
BLE_APPEARANCE_CYCLING_SPEED_CADENCE_SENSOR	LITERAL1
BLE_APPEARANCE_GENERIC_PULSE_OXIMETER	LITERAL1
BLE_APPEARANCE_PULSE_OXIMETER_FINGERTIP	LITERAL1
BLE_APPEARANCE_PULSE_OXIMETER_WRIST_WORN	LITERAL1
BLE_APPEARANCE_GENERIC_WEIGHT_SCALE	LITERAL1
BLE_APPEARANCE_GENERIC_OUTDOOR_SPORTS_ACT	LITERAL1
BLE_APPEARANCE_OUTDOOR_SPORTS_ACT_LOC_DISP	LITERAL1
BLE_APPEARANCE_OUTDOOR_SPORTS_ACT_LOC_AND_NAV_DISP	LITERAL1
BLE_APPEARANCE_OUTDOOR_SPORTS_ACT_LOC_POD	LITERAL1
BLE_APPEARANCE_OUTDOOR_SPORTS_ACT_LOC_AND_NAV_POD	LITERAL1
BLE_PROPERTY_READ	LITERAL1
BLE_PROPERTY_WRITE_WITHOUT_RESPONSE	LITERAL1
BLE_PROPERTY_WRITE	LITERAL1
BLE_PROPERTY_NOTIFY	LITERAL1
BLE_PROPERTY_INDICATE	LITERAL1
BLE_PERMISSION_READ_UNENCRYPTED	LITERAL1
BLE_PERMISSION_READ_UNAUTHENTICATED	LITERAL1
BLE_PERMISSION_READ_AUTHENTICATED	LITERAL1
BLE_PERMISSION_READ_AUTHENTICATED_SECURE_CONNECTION	LITERAL1
BLE_PERMISSION_WRITE_UNENCRYPTED	LITERAL1
BLE_PERMISSION_WRITE_UNAUTHENTICATED	LITERAL1
BLE_PERMISSION_WRITE_AUTHENTICATED	LITERAL1
BLE_PERMISSION_WRITE_AUTHENTICATED_SECURE_CONNECTION	LITERAL1
BLE_PERMISSION_SUBSCRIBE_UNENCRYPTED	LITERAL1
BLE_PERMISSION_SUBSCRIBE_UNAUTHENTICATED	LITERAL1
BLE_PERMISSION_SUBSCRIBE_AUTHENTICATED	LITERAL1
BLE_PERMISSION_SUBSCRIBE_AUTHENTICATED_SECURE_CONNECTION	LITERAL1
BLE_SECURITY_UNENCRYPTED	LITERAL1
BLE_SECURITY_UNAUTHENTICATED	LITERAL1
BLE_SECURITY_AUTHENTICATED	LITERAL1
BLE_SECURITY_AUTHENTICATED_SECURE_CONNECTION	LITERAL1
BLE_PHY_1M	LITERAL1
BLE_PHY_2M	LITERAL1
BLE_PHY_CODED	LITERAL1
BLE_PHY_OPTION_S2	LITERAL1
BLE_PHY_OPTION_S8	LITERAL1
BLE_DISCOVERABLE_LIMITED	LITERAL1
BLE_DISCOVERABLE_GENERAL	LITERAL1
BLE_UART_PROTOCOL_BLUEST	LITERAL1
BLE_UART_PROTOCOL_NORDIC	LITERAL1
BLE_UART_PROTOCOL_HMSOFT	LITERAL1

